agda_ls=atool.out
aiken=aiken.out
angularls=vscode-extensions.angular.ng-template.out
ansiblels=ansible-language-server.out
arduino_language_server=arduino-language-server.out
asm_lsp=asm-lsp.out
ast_grep=ast-grep.out
astro=astro-language-server.out
autotools_ls=autotools-language-server.out
basedpyright=basedpyright.out
bashls=nodePackages.coc-sh.out
beancount=beancount-language-server.out
biome=cdxgen.out
bitbake_language_server=bitbake-language-server.out
blueprint_ls=blueprint-compiler.out
bright_script=bsc.out
buck2=buck2.out
bufls=buf-language-server.out
cadence=flow.out
cairo_ls=cairo-lang.out
ccls=ccls.out
clangd=rocmPackages.llvm.clang-tools-extra.out
clojure_lsp=clojure-lsp.out
cmake=cmake-language-server.out
crystalline=crystalline.out
csharp_ls=csharp-ls.out
cssls=vscode-langservers-extracted.out
dafny=dafny.out
dagger=cuelsp.out
dartls=(hover.out)
denols=deno.out
dhall_lsp_server=haskellPackages.dhall-lsp-server.out
diagnosticls=diagnostic-languageserver.out
digestif=(zettlr.out)
docker_compose_language_service=docker-compose-language-service.out
dockerls=nodePackages.coc-docker.out
dotls=dot-language-server.out
dprint=dprint.out
efm=efm-langserver.out
elmls=elmPackages.elm-language-server.out
emmet_language_server=emmet-language-server.out
emmet_ls=emmet-ls.out
erg_language_server=erg.out
erlangls=erlang-ls.out
esbonio=(haskellPackages.udev.out)
eslint=vscode-langservers-extracted.out
fennel_ls=fennel-ls.out
flow=nodePackages.npm.out
fortls=fortls.out
fsautocomplete=fsautocomplete.out
fsharp_language_server=dotnetCorePackages.sdk_8_0_1xx.out
fstar=fstar.out
futhark_lsp=haskellPackages.futhark.out
ghcide=haskellPackages.ghcide.out
gleam=gleam.out
glsl_analyzer=glsl_analyzer.out
glslls=glslls.out
golangci_lint_ls=golangci-lint-langserver.out
gopls=gopls.out
groovyls=zulu11.out
harper_ls=harper.out
helm_ls=helm-ls.out
hls=haskellPackages.haskell-language-server.out
html=vscode-langservers-extracted.out
htmx=htmx-lsp.out
hyprls=hyprls.out
idris2_lsp=idris2Packages.idris2Lsp.out
jdtls=nodePackages.coc-java.out
jedi_language_server=python312Packages.jedi-language-server.out
jqls=jq-lsp.out
jsonls=vscode-langservers-extracted.out
jsonnet_ls=jsonnet-language-server.out
julials=vimPlugins.vim-codefmt.out
koka=koka.out
kotlin_language_server=kotlin-language-server.out
leanls=lean4.out
lemminx=lemminx.out
ltex=vscode-extensions.valentjn.vscode-ltex.out
lua_ls=vscode-extensions.sumneko.lua.out
markdown_oxide=markdown-oxide.out
marksman=marksman.out
matlab_ls=matlab-language-server.out
mesonlsp=mesonlsp.out
metals=metals.out
mint=mint.out
mlir_lsp_server=triton-llvm.out
mlir_pdll_lsp_server=triton-llvm.out
neocmake=neocmakelsp.out
nginx_language_server=nginx-language-server.out
nickel_ls=nls.out
nil_ls=nil.out
nim_langserver=nimlangserver.out
nimls=nimlsp.out
nixd=nixd.out
nushell=nushell.out
ols=speech-tools.out
openscad_lsp=openscad-lsp.out
perlls=(zulip.out)
perlnavigator=perlnavigator.out
perlpls=pls.out
pest_ls=pest-ide-tools.out
phan=php82Packages.phan.out
phpactor=vimPlugins.phpactor.out
postgres_lsp=postgres-lsp.out
prolog_ls=swiPrologWithGui.out
psalm=php84Packages.psalm.out
pylsp=python312Packages.python-lsp-server.out
pylyzer=pylyzer.out
pyright=nodePackages.coc-pyright.out
qmlls=kdePackages.qtdeclarative.out
quick_lint_js=quick-lint-js.out
r_language_server=rPackages.hexbin.out
racket_langserver=racket-minimal.out
regal=regal.out
regols=regols.out
relay_lsp=wiki-js.out
rls=rustup.out
rubocop=(xcode-install.out)
ruby_lsp=ruby-lsp.out
ruff=vscode-extensions.charliermarsh.ruff.out
ruff_lsp=vscode-extensions.charliermarsh.ruff.out
rust_analyzer=rustup.out
scheme_langserver=akkuPackages.scheme-langserver.out
scry=scry.out
serve_d=serve-d.out
shopify_theme_ls=shopify-cli.out
slint_lsp=slint-lsp.out
solargraph=rubyPackages.solargraph.out
solc=solc.out
sourcekit=sourcekit-lsp.out
spectral=spectral-language-server.out
sqls=sqls.out
standardrb=rubyPackages.standard.out
starlark_rust=starlark.out
starpls=starpls-bin.out
statix=statix.out
stylelint_lsp=stylelint-lsp.out
svelte=svelte-language-server.out
svls=svls.out
swift_mesonls=mesonlsp.out
syntax_tree=rubyPackages.syntax_tree.out
tailwindcss=tailwindcss-language-server.out
taplo=taplo.out
tblgen_lsp_server=triton-llvm.out
teal_ls=luajitPackages.teal-language-server.out
templ=templ.out
terraform_lsp=terraform-lsp.out
terraformls=terraform-ls.out
texlab=texlab.out
tflint=tflint.out
theme_check=(shopify-cli.out)
tilt_ls=tilt.out
tinymist=tinymist.out
tsserver=typescript-language-server.out
ttags=ttags.out
turtle_ls=trilium-server.out
typeprof=(taoup.out)
typos_lsp=typos-lsp.out
typst_lsp=typst-lsp.out
uiua=uiua.out
unison=toybox.out
vacuum=vacuum-go.out
vala_ls=vala-language-server.out
vale_ls=vale-ls.out
vdmj=zulu11.out
verible=verible.out
vhdl_ls=vhdl-ls.out
vimls=vim-language-server.out
vls=vlang.out
volar=vue-language-server.out
vuels=nodePackages.coc-vetur.out
yamlls=yaml-language-server.out
zk=zk.out
zls=zls.out
